+++++++++++++++++++++++++++++++++++++++++++++++++++++++++
+                                                       +
+                                                       +
+                                                       +
+                                                       +
+       0                                               +
+                                       A               +
+                                                       +
+                                                       +
+                                                       +
+                                                       +
+                                                       +
+                                                       +
+                                                       +
+                                                       +
+                                                       +
+                                                       +
+                                                       +
+                                                       +
+                                                       +
+                                                       +
+                                                       +
+                                                       +
+                                                       +
+                                                       +
+                                                       +
+                                                       +
+                                                       +
+                                                       +
+                a                                      +
+                                                       +
+                                                       +
+                                                       +
+                                                       +
+                                                       +
+                                                       +
+                                                       +
+                                                       +
+                                                       +
+                                                       +
+                                                       +
+                                                       +
+                                                       +
+                                                       +
+                                                       +
+                                                       +
+                                                       +
+++++++++++++++++++++++++++++++++++++++++++++++++++++++++
