+++++++++++++
+         A +
+0          +
+           +
+           +
+           +
+Aa         +
+++++++++++++
          