+++++++++++++
+   0  A   a+
+ +++++++++ +
+           +
+++++++++++++
