                             +++++++++++++++++                          
                          +++++        ++++++++++                       
                        +                ++++++++++                     
                       +                       +++++                    
                     ++                        ++++++                   
                    ++ +                         +++++                  
                    +  ++                       ++++++                  
                   ++  +                        +++++++                 
         0         ++   +                       ++++++++                 
         B  b      +++  ++                      ++++++++                
                   +++   ++                     ++++++++                
                   ++++++ ++++++++    ++++++++  ++++++++                
    +++++++        ++++++ +++++++++  +++++++++   +++++++                
    ++++  ++       +++++ +++++++  +     +++++++  +++++++         ++++   
   ++++++  ++      +++++  +++++++      +++++++   ++++++        ++  +++  
   ++++++   ++     +++++   +++++   ++   +++++     ++++       ++  +++++  
   ++++++++   ++    +++            ++             ++++       ++  ++++++  
    ++++++++    +++   +++ +++     +++  ++++++++++++++      ++  +++++++  
       ++++++++   +++   +++      ++++  +++++++++++++     ++   +++++++   
            ++++++  +++  ++++     +++ ++++++++++++    ++++  +++++++     
              ++++++ ++++++++       +++++++++ ++++  ++++ +++++          
                ++++++++++ +++      +++++++++ ++++ ++  ++++             
                   +++++++ ++ +++++++ +++++++++++ +++++++               
                     +++++  +++++ +++++++++++++++ +++++                 
                       +++    +++++++++++++++++++ +++                   
                         ++         +++++++++++++++                     
                          +++++     +++++++++++++                       
                           ++++    +++++++++++++                        
                            +++++  +++++++++++                          
                             +++++++++++++++++                          
                           ++      ++++++++++++++                       
                         ++      ++++  +++++  ++  +                     
                     +++      +++++      +++++   ++++                   
              +++++++       ++++            +  ++  ++++++               
            +++           ++++                +++++   ++++++++++        
           +++  ++      +++                      ++++         +++       
           ++++++++   +++                          ++++         ++      
            ++++++++ +++                             ++    +++++++      
              +++ ++++++                              ++  +++++++       
               ++++++++                                ++++++++       
                                                         +++++        
                                                                      
                                                                      